// Initial position, dirty probability, random seed, map
8 8 0.01 1
O O O O O O O O O O
O - - O - - - O - O
O O - O - O - O - O
O - - O - O - O - O
O - - O - O - O - O
O - O O - - - - - O
O - - - O - - O - O
O - O - - - O O - O
O - - - - O - - - O
O O O O O O O O O O
